
tropical = {
	519 520 521 522 523 524 525 526 #闽台
	527 528 529 530 531 532 533 535 536 538 539 540 541 542 543 544 545 546 571 572 573 #交州
	490 491 494 495 496 497 502 504 505 506 508 509 513 514 534 537 #南长沙-黔中-九江
	547 548 549 550 551 552 553 554 555 556 557 558 559 560 561 562 563 564 565 566 567 568 569 570	#南益州
}

mild_winter = {
	125 127 129 133 177 185 191 194 195 197 204 207 208 210 212 214 217 218 348 349 350 351 352 353 354 355 
        364 366 367 372 380 293 295 296 297 299 303 304 307 309 310 315 318 322 302 
        311 313 320 359 361 362 363 312 314 321 323 324 325 326 335 345 346 347 358 327 
        328 332 338 339 340 341 342 344 385 388 389 391 392 393 394 395 396 397 399 401
        403 356 357 365 368 369 370 371 373 374 375 376 377 378 382 384 387 390 398 285 294 298 300 306 308 316 317 
        333 301 305 319 329 330 331 334 336 337 343 618 620 845 846 856 857 858 859 860 861 866 867 868 869 870 871 862 863 881 882 883 884 885 887 892 893 894 895 896 897 898 899 900 901 902 903 904 905 906 907 908 909 910 911 912 913 914 915 918 919 920 921 922 923 924 925 926 927 928 929 930 931 932 933 985 986 987 988 989 990 991 992 994 995 996 997 998 999 1000 1001 1002 1003 1004 1005 1006 1007 1008 1009 1010 1012 1014 1015 1016 1017 1018 1019 1020 1021 1022 1023 1024 1025 1026 1027 1028 1029 1030 1031 1032 1033 1034 1035 1036 1037 1041 1042 1043 1044 1045 1069 1070 1071 1072 1073 1074 1075 1076 1077 1090 1148 1202 1247 1248 1249 1250 1251 1252 1266 1267 1268 1269
}

normal_winter = {
        1 24 25 34 35 36 37 39 69 71 72 73 74 75 76 77 78 79 80 86 87 88 
        89 90 91 93 95 96 97 98 99 100 101 102 103 104 105 
        106 107 108 109 110 111 122 274 112 113 114 115 116 117 118 119 120 121 123 124 126 128 130 131 132 134 873 874 872 875 876 877 878 879 880
        172 173 178 179 180 184 186 187 190 192 193 206 209 211 196 198 199 200 201 
        202 203 205 213 215 216 254 255 
        256 257 258 260 261 262 263 264 268 269 270 271 273 275 276 259 265 266 267 272 277 278 280 
        279 281 282 283 284 286 287 288 289 290 291 292 360 839 840 841 842 843 844 621 854  864 865 888 889 890 891 916 917 934 935 936 937 938 939 940 941 942 943 944 945 946 947 948 949 950 951 952 953 954 955 956 957 958 959 960 961 963 964 965 966 980 981 982 983 984 1038 1039 1040 1046 1047 1048 1049 1050 1051 1052 1053 1054 1055 1056 1057 1058 1059 1060 1061 1062 1063 1064 1065 1085 1086 1087 1088 1089 1098 1099 1100 1101 1102 886 1114 1115 1121 1140 1141 1142 1143 1144 1045 1046 1047 1048 1049 1050 1051 1052 1053 1054 1055 1056 1175 1195 1196 1197 1198 1199 1200 1201 1203 1204 1253 1254 1255 1256 1263 1288 1289
}

severe_winter = {
	2 3 4 5 6 7 8 9 10 11 12 13 14 15 16 17 18 19 20 21 22 23 26 27 28 29 30 31 32 33 38 40
	41 42 43 44 45 46 47 48 49 50 51 52 53 54 55 56 57 58 59 60 61 62 63 64 65 66 67 68 70 81 82 83 84 85 92 94 135 136 137 138 139 140 141 142 143 144
	145 146 147 148 149 150 151 152 153 154 155 156 157 158 159 160 161 162 163 164 167 
	169 189 165 166 168 170 171 174 175 176 181 182 183 188 574 575 576 
	577 578 579 580 581 582 583 584 585 586 832 833 834 835 836 837 838 844 616 617 850 
	774 775 776 777 778 779 780 781 782 783 784 785 786 787 788 789 791 790	  792 793 794 795 
	796 797 798 750 751 962 1066 1067 1068 1091 1092 1093 1094 1095 1096 1097 1103 1104 1105 1106 1107 1108 1109 1122 1123 1124 1125 1126 1127 1128 1129 752 757 754 753 725 755 647 1130 1131 1132 1133 1134 1135 1136 1137 1157 1158 1159 1257 1258 1259 1260 1261 1270 1271 1272 1273 1274 1275 1276 1277 1278 1279 1280 1281 1282 1283 1284 1285 1286 1287
}

impassable = {
	588 589 590 591 592 593 594 595 616 617 618 619 620 621 622 632 637 638 640 641 642 643 644 645 647 648 649 650 651 652 653 654 655 656 657 658 		659 660 661 662 705 706 707 708 709 710 711 712 713 714 715 716 717 718 719 720 721 722 723 724 725 726 727 729 730 731 732 733 734 735 736 737 738 
	739 740 741 742 743 745 746 747 748 749  752 753 754 755 756 757 758 761 762 763 764 765 766 767 768 769 770 771 772 773
799 800	 801 802 803 804 805 806 807 808 809 810 811 812 813 814 815 816 817 818 819 820 821 822 823 824 825 826 827 828 829 830 831 
	845 846 847 848 849 850 851 852 853 854 1219 1220 1221 1222 1223 1224 1225 1226 1227 1228 1229 1230 1231 1232 1233 1234 1235 1236 1237 1238 1239 1240 1241 1242 1243 1244 1245 1246 1359 1360 1361 1362 1363 1364 1365
}