max_provinces = 2200
sea_starts = {
	596 597 598 599 600 601 602 603 604 605 606 607 608 609 610 611 612 613 614 615 623 624 625 626 627 628 629 630 631 634 635 636 639 646
	663 665 666 667 668 669 670 671 672 673 674 675 676 677 678 679 680 681 682 683 684 685 686 687 688 689 690 691 692 693 694 695 696 697 
	698 699 700 701 702 703 704 728 967 968 969 973 974 975 976 977 978 979 1366 1367 1368 1369 1370 1371 1372 1373 1374 1375 1376 1377 
	1378 1379 1380 1381 1382 1383 1384 1385 1386 1387 1388 1389 1390 1391 1392 1393 1394 1395 1396 1397 1398 1399 1400 1401 1402 1403 
	1404 1405 1406 1407 1408 1409 1410 1411 1412 1413 1414 1415 1416 1417 1418 1419 1420 1421 1422 1423 1424 1425 1426 1427 1428 1429 
	1430 1431 1432 1433 1434 1435 1436 1437 1438 1439 1440 1441 1442 1443 1444 1445 1446 1447 1448 1449 1450 1451 1452 1453 1454 1455 
	1456 1457 1458 1459 1460 1461 1462 1463 1464 1465 1466 1467 1468 1469 1470 1471 1472 1473 1474 1476 1481
}
definitions = "definition.csv"
provinces = "provinces.bmp"
positions = "positions.txt"
terrain = "terrain.bmp"
rivers = "rivers.bmp"
terrain_definition = "terrain.txt"
tree_definition = "trees.txt"
continent = "continent.txt"
adjacencies = "adjacencies.csv"
climate = "climate.txt"
region = "region.txt"

border_heights = {
	350
	500
	700

}

terrain_sheet_heights = {
	350
}

tree = 350

border_cutoff = 2000.0